1111111111111111111111111111111
8003277770053710001000000000001
1010102222101111101110111111101
1013101000001000001020101000101
1006101000000000002010000010101
1011101011111111101011111010111
1000101000100010001010000010001
1010101110101111101010101111101
1010000010100010000010101010101
1011111010111011101110101010101
1000200010000010000000101000001
1011101011111110111110101010101
1010001000000010100000101010101
1410101011111010111011101110101
1310201020000000100010001000101
1111111111121111101110111011101
1010000000001000100010001010101
1010111011111011111011101010101
1000101000000010001000101010001
1111101111101110111112101010111
1010101000001010100010000010101
1010101011101010101110111111101
1000001010000010100000000000001
1111101110111110111110111111121
1000101000000000100017100000001
1011101011112111111010111011121
1000001010102010000000000000101
1110101010101010111111111110101
1000100000000000000010000007000
1111111111111111111111111111111